#Scotland#
SCO = "countries/Scotland.txt"
HSC = "countries/Alba.txt"
ILE = "countries/Theisles.txt"
ORK = "countries/Orkney.txt"
SHT = "countries/Shetlands.txt"
FAR = "countries/Faroes.txt"
ICE = "countries/Iceland.txt"
#Greenland
GNL = "countries/Greenland.txt"
THL = "countries/Thule.txt"
#England proper, Top down
NOL = "countries/Northumberland.txt"
DUR = "countries/Durham.txt"
YRK = "countries/York.txt"
LNC = "countries/Lancaster.txt"
WLS = "countries/Wales.txt"
WSX = "countries/Wessex.txt"
CRN = "countries/Cornwall.txt"
LOD = "countries/London.txt"
#Ireland
TYC = "countries/Tyrconnell.txt"
TYR = "countries/Tyrone.txt"
ANR = "countries/Antrim.txt"
CLN = "countries/Clanbeboye.txt"
SLN = "countries/Sligo.txt"
MYO = "countries/Mayo.txt"
GLW = "countries/Galway.txt"
KID = "countries/Kildare.txt"
DUB = "countries/Dublin.txt"
LAI = "countries/Laigin.txt"
URM = "countries/Ormond.txt"
THO = "countries/Thomond.txt"
DSM = "countries/DeasMhumain.txt"
WEX = "countries/Wexford.txt"
IOM = "countries/Mann.txt"